# 0 : empty
# 1 : wall

# p : player1 (red)
# P : player2 (blue)

# w : water
# l : lava

# W : water gem
# L : lava gem
# d : lava door
# D : water door

# g : gun shooting right
# G : gun shooting left
# f : gun shooting fire right
# F : gun shooting fire left
# b : gun shooting (blue) water right
# B : gun shooting (Blue) water left

100000000000000000000000000000000000000001
100000000000000000000000000000000000000001
10000p000000000000000000000000000000P00001
100000000000000000000000000000000000000001
100000000000000000000000000000000000000001
100000000000000000000000000000000000000001
100000000000000000000000000000000000000001
100000000000000000000000000000000000000001
100000000000000000000000000000000000000001
100000000000000000000000000000000000000001
100000000000000000000000000000000000000001
100000000000000000000000000000000000000001
100000000000000000000000000000000000000001
100000000000000000000000000000000000000001
100000000000000000000000000000000000000001
100000000000000000000000000000000000000001
100000000000000000000000000000000000000001
100000000000000000000000000000000000000001
100000000000000000000000000000000000000001
100000000000000000000000000000000000000001
100000000000000000000000000000000000000001
100000000000000000001100000000000000000001
100000000000000000001100000000000000000001
100000000000000000001100000000000000000001
11000000000000D000011110000d00000000000011
111000000000000000011110000000000000000111
11110000W0L00111000111100011100L0W00001111
111111111111111111111111111111111111111111
