# 0 : empty
# 1 : wall

# p : player1 (red)
# P : player2 (blue)

# w : water
# l : lava

# W : water gem
# L : lava gem
# d : lava door
# D : water door

# g : gun shooting right
# G : gun shooting left
# f : gun shooting fire right
# F : gun shooting fire left
# b : gun shooting (blue) water right
# B : gun shooting (Blue) water left

100000000000000000000000000000000000000001
100000000000000000000000000000000000000001
100000000000000000000000000000000000000001
100000000000000000000000000000000000000001
100000000000000000000000000000000000000001
100000000000000000000000000000000000000001
100000000000000000000000000000000000000001
10000000000000000000000W000000000000000001
100000000000000000000000000000000000000001
100000000000000000000000000000000000000001
10D00d000000000000000000000000000000000001
1000000000L0000000000000000000000000000001
111111111000000000000000000000000000000001
1111111111110W0000000000000000000P00000001
1000000011111111111000111000000000L0000001
100000000000000000000000000011000p00000001
100000000000000000000000000000000110000001
100000000000000000000000000000000111000001
100000000000000000000000000000000111100001
100000000000000000000000000000000000000001
100000000000000000000000000000000000000011
1000000000000000000000000W0000000000000111
100000000000000000000000000000000000001111
100000000000000000000000010000000000011111
1000000000000L00000000000100L0000000111111
10p0P0000000000000000000000000000001111111
100000001wwwwwwww111llllllllllllll11111111
111111111111111111111111111111111111111111
