# 0 : empty
# 1 : wall

# p : player1 (red)
# P : player2 (blue)

# w : water
# l : lava

# W : water gem
# L : lava gem
# d : lava door
# D : water door

# g : gun shooting right
# G : gun shooting left
# f : gun shooting fire right
# F : gun shooting fire left
# b : gun shooting (blue) water right
# B : gun shooting (Blue) water left

111111111111111111111111111111111111111111
111111111111111111111111111111100000000001
100000001111111111111111111111000000000001
10p00000P000000000000000000000000000000001
100000000000000000000000000000000000000001
1000000011000000000W000000L00000000000000F
10000000110000000000000000000000000F000001
111111111111111111111111111111111111000001
100000000000000000000000000000000000000001
100000000000000000000W0L0W0W0W000000000001
100000000000000000000000000000000000000001
1000000000000000001llllllllllll10000000001
100011111111111111111111111111111111111111
100000000000000000000000000000000000000001
g000000000000L0000000W00000000L00000000001
g0000000000L000L000W000W0000L000L000000001
g00000000000000000000000000000001110000001
g000000000L00000L0W00000W00L00001110000001
111111111111111111111111111111111111100001
100000000000000000000000000000001111100001
100D00000000000000000000000000000111100001
100000000000000000000000000000000000000001
111111000000000000000000000000000000000001
100000000000000000000000000000000000000001
1000000000000L0000000000000000000000000001
10d000000000000000000L00000000000000000001
1000000001111111111wwwww1000WL00001llllll1
111111111111111111111111111111111111111111
