# 0 : empty
# 1 : wall

# p : player1 (red)
# P : player2 (blue)

# w : water
# l : lava

# W : water gem
# L : lava gem
# d : lava door
# D : water door

# g : gun shooting right
# G : gun shooting left
# f : gun shooting fire right
# F : gun shooting fire left
# b : gun shooting (blue) water right
# B : gun shooting (Blue) water left

111111111111111111111111111111111111111111
100000000000000000000000000000000000000001
10D000000000000000000000000000L00000000d01
100000000000000000000001111111111111000001
11111llllll1WW1100001111100000000001ll1111
111111111111111110000000000000000001111111
100000000000000011000000000000000000000001
10000000000000000L100000000000000000000001
100000000000000000110010000000000000000001
100000000000000000000011100010000000000001
100000000000000000000000000000010000000001
100000000000000000000000000000000000000001
100000000000000000000000000000000000000001
10000000000000000000000000000001100000000F
1000000000000L00010000000000000000000LW001
1000000f00000000000000000000000000000WL001
100011111111111wwwwww111111111111111111111
100000000000001111111100000000000000000001
1W00000000000000000000000000000000W0000001
110000000000000000000000000000000000000001
100000000000000000000000000000000000000001
100000000000000000000000000000000010000001
100001110000000000000000000000000000000001
100000010000110000000L00000111000000000001
1100000100001110000001110000000000000000G1
10p0P0010000000000000000000000000000000G11
10000001100000000W00000000L00000000000G111
111111111111111111111111111111111111111111
