# 0 : empty
# 1 : wall

# p : player1 (red)
# P : player2 (blue)

# w : water
# l : lava

# W : water gem
# L : lava gem
# d : lava door
# D : water door

# g : gun shooting right
# G : gun shooting left
# f : gun shooting fire right
# F : gun shooting fire left
# b : gun shooting (blue) water right
# B : gun shooting (Blue) water left

100000000000000000000000000000000000000001
100000000000000000000000000000000000000001
100000000000000000000000000000000000000001
100000000000000000000000000000000000000001
100000000000000000000000000000000000000001
100000000000000000000000000000000000000001
100000000000000000000000000000000000000001
100000000000000000000000000000000000000001
100000000000000000000000000000000000000001
100000000000000000000000000000000000000001
100000000000000000000000000000000000000001
100000000000000000000000000000000000000001
100000000000000000000000000000000000000001
100000000000000000000000000000000000000001
100000000000000000000000000000000000000001
100000000000000000000000000000000000000001
100000000000000000000000000000000000000001
100000000000000000000000000000000000000001
100000000000000000000000000000000000000001
100000000000000000000000000000000000000001
1000000000000000000L00000000000000000W0001
10000000000000000000000000000000000W000001
100000000000000000000000L00000000000000001
10000L000000000W00000000000000000L0000W0L1
100W000000L0000000000W0000L00W000000000001
1L000p0000W0W0000D00L000W000d00000L0P00001
100LW0000L0000WW000000L00W0000000W00000W01
111111111111111111111111111111111111111111
